WWWWWWWWWWWWWWWWWWWWWWWWWWWWWWWWWWWWWWWWWWWWWWWWWWWWWWWWWWWWWWWWWWWWWWWWWWW
W----------------W----------------W---------------------------------------W
W----------------W------WWW-------W--------------------------------------CW
W----------------W----------------W----------m--------Z-----------------CTW
W---------Z---------------Z-----W----------------------------------------CW
WWWWWWWWWW---------m-----------------------------WWWWWWWWWWWWWWWWWWWWWOWWWW
W---------------------------------W---------------W-----------------------W
W---------------------------------W---------------W-----------------------W
W------------WWWWWWWWWWWWWWWWWWWWWWWWW------WWWWWWW------------Z----------W
W------------W-----------------------W------W-----------------------------W
W------------O------------------------------------WWWWWWWWWWWWWWWWW-------W
W----CTC-----W----------------------C-------------W-----------------------W
W------------W--------WWWWW--------CTC------------W-----------------------W
W------------W----------------------C-------------W-----------------------W
W------------W------------------------------------W------m--------W-------W
W------------W--------WWWWW-----------------------W---------------W-------W
WWWWWWWWWWWWWW----------------------m-------------W---------------W-------W
W------------W------------------------------------W---------------W-------W
W------------WWWWWWWWWWWWWWWWWWWWWWWWWWWWWWWWWWWWWWWWOWWW----Z------------W
W-------Z---------W-------------------------W-----------W-----------------W
W-----------------W-------------------------W-----------------------------W
W-----------------W-------------------------W-----------W-----------------W
W---------m-------W-------CTC---------W-----WWWWWW---WWWWWWWWWWWWWWWWWWWWWW
W-------------------------------------W-----W-----------------------------W
W-------------------------Z----------W--------------------Z---------------W
W-----------------W-------------------W-----W-----------------------------W
WWWWWWWWWWWWWWWWWWWWWWWWWWWWWWWWWWWWWWW-----WWWWWW-------WWWWWWW----------W
W------------------------------------------------W-------W----------------W
W-----------------m--------------------Z--------W-------W-----------------W
W------------------------------------------------W---WWWWWWWWWWWWWWWWWW---W
WWW---WWWWWWWWWWWWWWWWWWWWWWWWWWWWWWWWW----------W------------------------W
W-------W------W-----W----------W----------------W----------------m-------W
W-------W------W-----W----------W----------------WW------WWWWWW-----------W
W--Z----W------W-----O----------W-------------------------W---------------W
W-------O------W-----W----------W-----------N----Z--------W---------------W
W-------W------W-----WWWWWWWWWWWW-------------------------W---------------W
W-------W------W--------------------m------------W--------W---------Z-----W
W-------W------W------Z--------------------------W--------W---------------W
W-------W------W----------------W----------------W--------W---------------W
ẂWWWWWWWWwWOWWWWWWWWWWWWWWWWWWWWWWWWWWWWWWWWWWWWWWWWWWWWWWWWWWWWWWWWWWWWWWW
