WWWWWWWWWWWWWWWWWWWWWWWWWWWWWWWWWWWWWWWWWWWWWWWWWWWWWWWWWWWWWWWWWWWWWWWWWWW
W................W................W.......................................W
W................W......WWW.......W.......................................W
W................W................W.......................................W
W.................................W.......................................W
WWWWWWWWWW........................W...............WWWWWWWWWWWWWWWWWWWWWOWWW
W.................................W...............W.......................W
W.................................W...............W.......................W
W............WWWWWWWWWWWWWWWWWWWWWWWWW......WWWWWWW.......................W
W............W.......................W......W.....W.......................W
W............O....................................WWWWWWWWWWWWWWWWW.......W
W............W....................................W.......................W
W............W........WWWWW.......................W.......................W
W............W....................................W.......................W
W............W....................................W...............W.......W
W............W........WWWWW.......................W...............W.......W
WWWWWWWWWWWWWW....................................W...............W.......W
W............W....................................W...............W.......W
W............WWWWWWWWWWWWWWWWWWWWWWWWWWWWWWWWWWWWWWWWOWWW.................W
W.................W.........................W...........W.................W
W.................W.........................W...........W.................W
W.................W.........................W...........W.................W
W.................W...................W.....WWWWWW...WWWWWWWWWWWWWWWWWWWWWW
W.....................................W.....W.............................W
W.....................................W.....W.............................W
W.................W...................W.....W.............................W
WWWWWWWWWWWWWWWWWWWWWWWWWWWWWWWWWWWWWWW.....WWWWWW.......WWWWWWW..........W
W................................................W.......W................W
W................................................W.......W................W
W................................................W...WWWWWWWWWWWWWWWWWW...W
WWW...WWWWWWWWWWWWWWWWWWWWWWWWWWWWWWWWW..........W........................W
W.......W......W.....W..........W................W........................W
W.......W......W.....W..........W................WW......WWWWWW...........W
W.......W......W.....O..........W.........................W...............W
W.......O......W.....W..........W.........................W...............W
W.......W......W.....WWWWWWWWWWWW.........................W...............W
W.......W......W.................................W........W...............W
W.......W......W.................................W........W...............W
W.......W......W................W................W........W...............W
ẂWWWWWWWWwWOWWWWWWWWWWWWWWWWWWWWWWWWWWWWWWWWWWWWWWWWWWWWWWWWWWWWWWWWWWWWWWW
